Arcade Fire - Everything Now
Lorde - Green Light
Milky Chance - Cocoon
Marian Hill - Down
BANNERS - Someone to You
Sofi Tukker - Best Friend (feat. NERVO, The Knocks & Alisa Ueno)
Bleachers - Don't Take the Money
Foster the People - Sit Next to Me
Imagine Dragons - Believer
Judah & The Lion - Suit and Jacket
Sylvan Esso - Radio
Phoenix - J-Boy
K.Flay - Blood in the Cut
Muse - Dig Down
Glass Animals - Youth
Missio - Middle Fingers
The National - The System Only Dreams in Total Darkness
Portugal. The Man - Live in the Moment
COIN - I Don't Wanna Dance
Nothing But Thieves - Sorry
Alice Merton - No Roots
Sylvan Esso - Die Young
Foster the People - Doing It for the Money
Bastille - Send Them Off!
Sir Sly - &Run
Arcade Fire - Creature Comfort
The Revivalists - Wish I Knew You
alt-J - In Cold Blood
Sir Sly - High
The xx - On Hold
Young the Giant - Silvertongue
Cold War Kids - Love Is Mystical
MISSIO - Bottom Of The Deep Blue Sea
Manchester Orchestra - The Gold
The Killers - The Man
Portugal. The Man - Feel It Still
